gjd1a_off02	CAGCGATCTGTGGAGCAATGAAAGATTGGACAGTGACCATGGAACAAGAGGAGGCCTGGATTGTGGATGGCCATGAACATGGACTATATTAGAGCAGTGAGTTTAATACACAGTGCATCCAGAAAGTATTTATAGCGCTTTACTTTTTCCACATTTTTTTATGTTACAGCCTTATTCCAAAATGGATTTAATTAATTTATTTCCTCAAAATTCTACACACAATACCCCATAATGACAATATGAAAAAAGATTTATTTAAATTGTTGCAGATTTATTAAAAATAAAAAACCTGAAAAATCGCATGTACAGTAAGTATTCACAGCCTTTGCTCAATACTCTGTTGATGCA	GAACATGGACTATATTAGAG
nlgn4a	TGGGTTGTACCTTGGCTTTGGAGGAGTGGAGGACTTTGAATTCAAGCAACTCTGCCAACCGCAGCTGGACCATGTCACGGCTCAGAGGAACCCCATGGATACCACTTACCATGGTTCATCCGCTGGCTACTCTACGCCTTTTTACCTGGATTGTGCTTGCGGCTGCGTGGCTGGCCATTACATGGGCTCAGCAGCACCCTATTGTTACGACAAACTATGGCAAGCTAAGAGGCTTGAAAACACCTCTGCCCAATGA	GGATTGTGCTTGCGGCTGCG
cntnap4	TCAATTGTGTGGATTCCGGCATTTCTTACAGTGCATGTGTGTGTGTGTCGTGCAGGTGCTGGGGGCTGGTCTCCGCTGGACTCTAATAAGTATCAGTGGCTGGAGATCAAGCTGGAGCAGCGCACTGAGATTACGGGGGTCTCCAGCCAGGGCCGATACGGCAGCTCAGACTGGGTCACTCGCTACCTCCTCATGTTCAGTGACACGGGACACAACTGGAGACCGTACCGCCAGGAAGACAGCATAGG	GTCTCCAGCCAGGGCCGATA
tjp2a	AAGATCGGAAAAACCCTCCACATCAATTAATGTATGGATTCATTACATTTTTATGAAACCAATTCTATTCCTTGATGTAGGACTCCAAGATGGGCTTTGGCCTAGCGGTGTCTGGAGGACGGGACAATCCAAACGAAGAAAGTGGAGAAATGTCAATCGTCATATCTGATGTGCTGCAAGGGGGTCCAGCCGATGGCTTGCTGTTGTAAGCTATAATATTATATTTCTTTCAACACAGCCCTCAACCTGTGA	GGCTTTGGCCTAGCGGTGTC
nlgn2b	GCGTAGGGGACACCCAAGTACTGCTCGACCGGGCCTAGAATCTCATTGTTCAGCTCCTTGCGTACTCCCCGAAGCTTCCCGTAGCCTGTGGTGACCATAGGGTGCTTGGCGGCGGTGAGGTCTGCCCGTTGGCAGGAGGATAGCGCAAGGCGCAGCGCCAAGCCCAGCAGCCACACCAGGCAAGTGTCAGATATGCGTCGTGGACAGGAGCGAACCGTCT	GGTGACCATAGGGTGCTTGG
nlgn1	ACTGAGTTGCGTTGCGGATTTCTGACCACGAAATAGGGGGTTCAGGTGGCTGGAAGCGCCTTTCGCCTGTTGGAGGTGCTGCGTAGGGAACCCCCAGGAACTGAATAACAGGCCCCAAGATCTCATTATTGAGTTCTTTTTTGAATCCCCGCACTTTTCCGTAAGTGGTAGTGACAATGGGGTCCGTTTCATCCAGTTTTTCCGAAGCGGCCAGCTGGGCATGCAGGGCCAAGCCTACTATCCAACACAAGAATGGCAGATCCAGGC	GTGCTGCGTAGGGAACCCCC
cntn2	GCAAGTAAAGGTCGTGTTTTGTTCGTTCACGTGTAAATGACAAAAATGTGATGTGAGTACCGGTAAACAGCAGCAGGGCTGGAGCGAGCCTGGCAGCTCAGGGTCACCTTGCCTTCTGGCATCCCCTCTGGGTAAATCAGACTAGATGGCTGCTCTTCAAACACCGGCCCACTGTCATGACCCGACACACACACATCCCCACCTACCAAAAA	GGAGCGAGCCTGGCAGCTCA
CNTNAP5	AGCGAGTGCCTGAATTGTGAAGAGAATTACCCCCTGAATTCTGTTTCATTCCTCTGCAGTTTTTAAAGCACTGCCTCTTAATCTGTCCCCCTAGGAGGTGGGGGGTGGTCTCCGAGCGGAGAAGACCAGCAACCTTGGCTTCAGCTGGACCTACGGGATAGGTTGAAGGTCACATCCATTGCCACCCAGGGTCGCTGGGGCAGCTCTGACTGGGTGGCTCGGTACCAGCTACACTACAGTGACTCTGGACGAACCTGGAGACCGT	GGACCTACGGGATAGGTTGA
nrxn1a_L	ACAATGAGCTTCTCAATGCGGAACGGTGCACATCTAATCTGGATAGGCCTACTGGTTTGTTGCCTTGTCGACATGGGGGCCAGCATGGAGTTCACTGGTGCAGAAGGCCAGTGGGCAAGGTTTCCCATGTGGAACGCCTGCTGCGAAAGCGAAATGAGTTTCAACATGAAGACCAAAAGCGCTCATGGACTTTTAGTGTACTTTGACGACGAGGGATTCTGTGACTTCTTGGAACTGCTCATCCACAATGG	GGGGCCAGCATGGAGTTCAC
nrxn1a_S	CAGGTGGTTTGAGGACACCCCTCTTTAAAGTCCTTGCACTCCGGTAGCATGCTGCGTCTGTGGCCCGGCGGGGCTCCTGGTGGTCTTGCTTCCATCCTGCTCCGCATCAGCCTGCGCCTAGCTCTCTGGCTGCCACCGCTGACTTTGGGGTCAGCTCTGGCAGAGGGGCCTGGGGAGCTGTACGTCCCTCAACATATGCCTCATCACCTCGTGCCTGCCGCCAGATCCCACGCCCCCCTGCGGGCAGGACATGGTGCGTAGCTTATTCGACAGCCA	GGCTGCCACCGCTGACTTTG
nrxn1b_L	GCAACAATAACATCTGGTGCCACCTTAAACCTACTTTGGCATGCATAATTTGGAGATTTCCTATAGATTATTATTATTATAAACATGCCAAACATCTTCATGATGATTCTTCACTTGGGTGCTCATCTGCTTTTTATCGGACTAATTGTATGTAAAGCGAACGCTGGATCTAGTCTCAGGTTTACAGGATCCGACGAACAATGGGTTGCGTTTCCGATGTGGAACGCTTGCTGCGAGAGCGAAATGAGCTTCAGTGTGAAAACCACACATCTGAATGGCCT	GGATCTAGTCTCAGGTTTAC
nrxn1b_S	CCGGTGTGCTGAAGTGTGTGTTTGTGCTCCGGGAAGATGTTTGGAGGCTGGAGGCTGGTGGTTTGGCAGATTTTTTCGGAGATCATCACTCGGCGTTTGGGCTTCTGGATCTGCCTGTACTTCGCAGCTCTGTCTGTGGGCATGATTTCTGGATCGGAGCCCCTCGTCAGGACACGACACATCCAGAATACACACACTGTGCCTATCAACAGGTCACCGGGGTCTCTGCGGGCATGGCAGGGTGGGTACAACAGTA	GGAGATCATCACTCGGCGTT
nlgn3a	GGGCAAGGCTACTACCCCACAGTCAATACACAGTACGGGAAATTACGGGGGGCGCGGGTTCCGCTGCATAGTGAGATCCTGGGACCAGTGGACCAGTACCTGGGAGTCCCGTATGCCACCCCACCGGTGGGTGAAAAACGATTCCTACCCCCTGAGCCACCCTCGTCTTGGTCCGGGATCAAGAATGCCACTCATTTTGCACCAGTGTGCCCACAAAACATTCACA	GGGACCAGTGGACCAGTACC
gjd1a_off03	ACGCTGAGGTCAGCAACAGACTTGCACATTCTCTACAGCTGATCTAATGTTTGAAATGCAGATTTCAAGACATTAAAGCCCACCGAGAGTGTTAGTAGAGTAAAACCTTCGTGATATAGTACATGAAACCCCTAGTTCAAATATAACAGGCGGAAGGAGGATGTGATATATTGGAGAAGCAAACAGTTTGCTCTCTTCACAGAAAGACACCACATCATATAATCTGATTATGATGAAGTGCTCCATATGGAGGCTGATCAGAGTCACGAACAGCTCCTCTCATGCACAA	GAGGATGTGATATATTGGAG
gjd1b	GCCATCGGCGGAACTATTTTTAGGAACAAAGTATTGCAGTTCCTGTTGACTACCTCAAAGAGAAGCCACGGAGACTGTAAGATATCTTTGGAGGTTTACTTAAAGGATCGCTCGGTGTCTATTATAGTGTCTATTGATCCCTGGATGTCTTCAGCACCCAGCCATGGGAGAGTGGACCATTTTAGAGCGCCTCCTGGAGGCCGCTGTGCAGCAGCACTCTACTATGATCGGAA	GACCATTTTAGAGCGCCTCC
tjp1b_B_off01	GCAAATGAAAAAGAAAGCCAAACCAACAGTGAAAAGTCTAATTATTTCCATTAACCTGATGATTTTAATTGAGATCTCCAGTGATATGTCTCCAACGCAGACGGGAAGCGCTTGTGGCTCGCTGGAAGTTGATAAAGGAATCTCAGTCCGCGAGCTTTTAAAATTAGGATAGGAAATTGGAGCAAGCCAAAAAGGAGACTTTAATTTTACAGAATTATTGTGACGCCCGGGGGCTTGAACCGAATGATTGCTGCCTGTTCT	AAGCGCTTGTGGCTCGCTGG
cnsta	CATGCACTGCTCTCAGAAAGCCTGAAGCACAATTACTGCTGAACTATGAGTCAGTTCAGTTAAAGGCCGGCTATTTCTTTACTGTTCCTGATTATTCTGTGTCTCCCAGAGGCAGAGCGGAGCGGCGTCCAGTGCCTGAGCGGATCTTGATGGATGACGGTCAGTGGCAGAGCGACGGCCCTGTAAGGAGAGGAGGAGCGACTGAGCCGGAGCTACAGAGCTGCTCTGAGTCCTTCCGCAGCCCTGATGACAACCACAACCGGCTGCT	GGCAGAGCGACGGCCCTGTA
nrxn3a_S	AGTGTGAGTCGGGTGTGCGTTATGCGTCCCAGCAGAGTGGCGGCGCCGTTTCGGGGCGGTCGCCAGGGATTGAGCCCATGGATGTGGTCTCTGACTTTGGGATGTATTGTGGGTTCGGTGTGGAGTTCCTCACCTGGCTTGGATAATTCAGTGGTCGCCGCTGGACCTCCTGGGGTGGCAACTTCATACACCCATCCTGAACACCCGGTCCACAACCCTCGGCACCACGCTTCACCCATTTCCATAT	GATAATTCAGTGGTCGCCGC
nrxn3a_L	GCCGCCATCGTCAAAGTACAGGATTAAGGCAGTGGACACGTCTGTTTTGAACTGGAAGCTGAGGTCACTTCTGGTGCTGGCGTCCCAGCGGAGATAGCGTGCCCACTGGCCTTGCAACCCTGTAAACTCCAGGCCCAAGCAGGGCCCAAGCACAGTACTGATCAGCAGCTGCAACTGGACTGGAAATCTGAAGAAATTCATTGTAAAAGTGCTGGAGATTTGGGGTTATTATCCTGAACAGAAGGAAATCATTGAATTCGCTTTGGTTCAAAGGTCA	GTAAACTCCAGGCCCAAGCA
gjd2a	CCACAACTGCGGACACTGAGAGGAATTACTCGCGCTTTCGTCTGGATCTGGGGCAGAGTCTGCGGATGAGCAGCGATGGGAGAATGGACCATACTAGAGAGGCTCTTGGAGGCTGCTGTCCAGCAGCACTCCACTATGATCGGAAGGTAAGAGCTAATGTCAGCCTGTCTGACGCCGAAATTCAAGCTTTGCGGCGTTTTCGGAGTAGAAGAT	GAGAATGGACCATACTAGAG
cntn5	TTGCTTTTGCAGTTGGCTGATCAATGGAACGAATGTGGACACAGAAGCAGATTTCCGCTACAGTTTGATTGATGGAAATTTAATAATACACAATGCAAGCGAAGTCATCGATTATGGAAGATACCAGTGCAGAGCTGAAAACAGCATTGGCATCGTCTTGAGTCGAGACGCCCTCCTGCAGTTTGCCTGTGAGTAATCTCGAACCC	GCAAGCGAAGTCATCGATTA
cntnap2b	GGGACTTTAAAGCGCAGTTCCTCACAGTGCTTAAAAGGTAAATCCTCTCGAGGGGAAGTGATAAAAATAAGCTTACAACTGAGTTCTAGGCGAATGAAGTCGGGGTTGCCCAGGTTCTCCAGAAAGACTCCGTGTGAAGCCGATGTCTTAAAATAAAAGGACACATCAGCACTGGTCTCAGCTTGTAAGGTTGGAAAATGAAGATAAGATGCAGGTGTGTTGAAAGAAGCAGCGTTCC	GAATGAAGTCGGGGTTGCCC
CNTNAP2	GTCCTGCCGATAGGGTTTCCAGTTGCTTCCAGTGTCGCTGTACAGGAGCCTGTAGTTTTTGGTCCAGTCTGAGCTGCTGTATCTGCCCTGCGTTGCGATGGCTGTGATCTGTTTTCTGGCCCGGAGGTCCACCTGTAGCCACCGGTACCTGTCCGAGTCTGATGGTGACCATCCGCCATTGCCTTTCAAAGAGGAAGAACAATGGAAGAAAACAACACTAGATGCCAAGTTTGAATTACGATGCTTTAGTGCACACCGCA	GTATCTGCCCTGCGTTGCGA
nrxn3b_L	TGTAGCATACGCTCTGGCTACCATGCCTCCCCATTGCCAGCCTCATTGTGTACTCTTGCTGCTCAGCACCTTCTTGAGTCTTGGTTTGGGCCTGGAGTTCACAGGTTCAGAGGGTCAGTGGGCACGCTATCTTCGCTGGGATGCCAGCACCAGAAGTGACCTCAGCTTTCAATTCAAAACGGCAATATCAGATGCTCTGGTTCTCTACTTTGATGATGGAGGATATTGTGACTTCCTGCTTCTGAGTATTGAGGATGCCAAGCTCAAGTTGCATTTTAGCGTGGACTGTGCAG	GGTTTGGGCCTGGAGTTCAC
nrxn3b_S	AACGGACGTCAGGTTCTGCTCACCTGTTTCTCTCAATACACCTGCTAAAAGCTGTCTACTCTTGCAGCAAGGAGGGGACGATAGCTATGCGCCCCCACTTTAAGACCCGATACCCCCAGTGGCTTTCCTGCATGCTACCCCTGGTCACAGGGTGCGTGTTCGGAGCCGTATGGGGCTCGAACCTTGATAGCACAGTCGTCCTCTCGTCCTCCACATTCTCACATTCTGAAACACAGCACCACCATCACCTG	GGTGCGTGTTCGGAGCCGTA
gjd2b	AGACGCGAAACAGTTGCTCGCATTTGATTTCACACGGTTCTCTGTGTTACATTCGCCTCCGAATGAACAGCCATGGGGGAATGGACAATTCTCGAGCGTCTCCTGGAGGCGGCTGTCCAACAGCACTCTACTATGATTGGGAGGTGAGGGGAAAAAGTGTTGTGGAAAATGTTTATTGATAAGGTAGTACATTAAACAAAACACTGAGGTCATTACGCATTGACCCTTCTGACTAAGGGCGATTGGCTTCTGG	GACAATTCTCGAGCGTCTCC
cnstb	TGCGTAAGCGACAGAAGGGTGAAGAATTTAAAAAAACATTTTCAAGATAGATATGGTTTCATTTGGATTATGGTCTATCTTCTTTGTCATCACATCACAGTTATGGGGGAGTCCGAAAGCAGGAAATCGGTGAGATGGAAAGAGACGAGTGGAATCAACAAAGCATCAGAGGACATGATCATCTCTTACCTGACAGTCTCTGATGAGAATCAGAACAAACTGCCAGAAACAGAAGTCATGAACGCGG	GGAGTCCGAAAGCAGGAAAT
nrxn2a_S	TGATTGATATGGGCACCGCTCTTTGAGATGTACTCTTTCCAACGGATGGGACAAATGGGGTGTGGAAGGGCCTACGCCGGGCCTTCTTGCCCCAAGCTGGAGGTGGTGCTGCTGGGCTGGGAGTGTGGTGGAGGGGGCAGCTGGCTGGGCCTCGGCTCTTGGTGGAGACTGGCGCTATCTCTGGCCTTGTTGGCCTCTGTGCCGGACAGATCTGCCAGCGCCCGTGTGTCTTCCAGCCTGAGCACCACACACCATGTCCATCACTTCCA	GGCGCTATCTCTGGCCTTGT
nrxn2a_L	TGCAGTGGATTAAGGGAAACGGAACATTAGAAAGGAAGGATTAGGAGCTTGCTTAGAAGATGATGACGCGAAAGTGGAGGTGCGTGAAGTTGTCACCGGCCTTCGTTTGGCTGGGGCTCGTGGTCCTTTCTGTCACCACGGCCCTAGAGTTTGATGGTTTACCAGGCCAATGGGTTCGCTATGGACCCTGGGAAGCAGGAGCTACCGGTGAACTGAGCTTTACCATGAAGACGAACATCAGCAAAGCTATTGTGCTGTACCTGGATGATGGTGGA	GTCACCGGCCTTCGTTTGGC
cntnap5b	AGCAACGCTGGAATTGCTCACTCCTTCTGTTCTTGTGTTAGGAGGTGGCGGCTGGGCTCCGGAGCGAACAGACAGGCTACGATGGCTACAGGTGGACCTGCAAGAAAGGGTCGAGGTCACAGCTGTGGCGACCCAGGGTCGTTTCGGGAGTCCTGATTGGGTTACGAGTTACATGTTGCTGTACAGTGACACAGGGAGAGCTTGGAAGCAGTTCAGACAGGAGGACA	GGTCACAGCTGTGGCGACCC
tjp3	ATTCCAAGGTGGGCTTTGGTTTTGCCGTCTCAGGTGGGCTGGACAAACCCAACCCAGCAAATGGGGACGCGGCAGTGGTGGTCTCTGATGTGATTCCCACCGGTCCCGCCATGGGCCGACTTCAGTGAGTGCACGTGTTTCCTCCTCCACATCCTGCATAAATCCTGTAGAACCTGTCATGTTTGTGTACAAGACTGAAAAACTAAACTCACTTGCCAGCTGATTTTGGTGATAGAGACTCATGTGATTTCTTGCCCGTAGGACGC	GATTCCCACCGGTCCCGCCA
cntn3a	GGAGTATCACCATCACTGCGGAGAATAAGAGGTGTAGGAGGTCCTTGCACTCTGTTTTGGGTCACAGTGTTAGTCACGACACAGGTGTAGTTTCCTACATCCGATGGCTCCACTTTAGCAATGTACAGGTTGCCTGTTTTCTGTGACACAAAGCGCCGCGTGTCCTGCTCGACGAATGAGGGATATTCGTTGAAGATCCAGGAAAAGGTCAACTCTGTAGGAGACAAGAAGTGTAATAAGCTATACTGAACCGCATCTCTTTGGA	GTGTCCTGCTCGACGAATGA
tjp1b_L_off02	AGGAAATTAGGCTGAGCCGGCAGAAGAGAAGCAAGAGATTCTGTGCATGTTCTGAACAGAATAAGAAATGAGAGGCAGATCGATGGACACTTTACAAGTAAAGATACCCAGCGGGCAGCAGTGGATGAGATGGTAACCTCTCACCTCTGAACAGGCTCCAGTCGTGGCCTCGCATACGCACAGAACCGACTGATTCTGGACACGGTTCAACCAGCGCACTGTC	GCGGGCAGCAGTGGATGAGA
cntnap2a	CAGGGGGTGATCTCTTACCGCTTCAAAATGAAGAAGATGAAGATTCTGAAGGACGTGATAGCCCTGAAGTTTAAAACATCTGAGAGTGAAGGGGTGATTCTGCACGGAGAGGGTCAACAGGGAGACTACATCACCTTGGAGTTGAGAAGAGGCCGACTTCTGCTGCAGATAAACCTCGGTAAAACTCAGACCTGACATCTACTGCACACTCTTAAAAATAAAGCTGCTTTATTGGCATCAATGGTTCCA	GGGGTGATTCTGCACGGAGA
cntn1a	ACCAGCCAGTGCGGCTTATCTGAGCTCTGTCTGCTTCAGGTGCGGTACTGGCGTGAGTCTGTAGAGAACGAAGCGTCTGCTCAGCGGGTTCTGGTGTCCAGTCGAGAGAATCACACACGTCTGGACAACATGAAGCCCGACTCACACTACCTGGTGGAGGTGCGCGCGTGTAACGGAGCCGGATACGGACCCGCCAGCCAGCGCAACAGGATATACACCAAGAAGTCCCGTAAGTCCCTCAGCTGCA	GAAGCCCGACTCACACTACC
tjp1b_L	CCTTCAGGCCGTGTGGGAATGTAACCAATTAAAGCTGTTGATGTTAATCTAACGATTTGTGTGTTTCTCTATTAATCTCTTTCCTTCTTTCTGTGTGTTTTTTCTTCAATGCAGAGTGCAGCAATGGATGAGACGGTAATATGGGAACAGCACACTGTAACTCTACACAGGGTGAGAATTTCACTTTTTTTTTCCGATCTCTGTTATTTTTGTGTGTTTGGAGTCCCAGAGCAGA	GAGTGCAGCAATGGATGAGA
tjp1b_B	CATGGCCCGTTTCCACTGCAATAAATAAAGTGATGTATTAATAAAGTCTTGCATTGTTTTGATATAGGTATTCAGTCATTTCAGTAAACTGATTTTAGTGCATGTAATCATTTGAAGGTGTTGAGAGAGAGCAGTCTCAGATGTGTGTTTGTGTGTCCGTCCTCAGGCCGAGCATGAAGCTGGTGAAGTTCAAGAAGGGCGAGAGCGTGGGCTTGAGGCTCGCTGGGGGGAACGACGTTGGGATATTTGTGGCGGGAGTTCTGGAGGACAGTCCTGCTGCTAAAGAGGGCCTGGAAGAGGGAGACC	GTGGGCTTGAGGCTCGCTGG
cntnap1	ATTTTCTGATGACGCAGGGAGCAGTGGCTGGTCTCCGTCTACTCGGGACAGGCAGCCATGGATGCAGATTGACTTGGGGAGGAAGTATCGTATTATGGCCATTGCTACTCAGGGTACCTTCAACTCTTATGACTGGGTCACCAAATACATGGTGCTGTACGGTGACCGCTTTGACTCATGGACTCCATACGTCATGAAAGGAGGCAACATGGTA	GGGGAGGAAGTATCGTATTA
cntn1b	GGCGGGGCTTACCCATAGCTCAATTGGAAAAAGTTCTGTAGCAGAAGTTCATTAATGAAATGCCATACTTCACAGGTGGTGGTTAAACAACTGGCAAATTAAGCTGATGGAGCAGCCAGATGAGCACTTCAGCCTGGTTGGAGGAAACCTGGTCATTACAAACCCAGAAAAAAACAAGCATGCTGGAAAATATGTATGTGTGGCCAAGAACGTGTACGGCACCGTCATGAGCAAAGAGGCCAACGTCAAGTTTGG	GATGAGCACTTCAGCCTGGT
nlgn3b	TGCTCGTGTGGTTGATGTGGTCAGTCTCTGTGGCATCAACGCTGACCTACCAGCCAACAGTAAACACAGCTCTTGGCAGACTGAGGGGGATGCGGGTCGCTGTTGCCACGGAGGGTCTGGGACCTGTGGATCAATATCTGGGTGTGCCTTACGCCGCTCCGCCTGTGGGAGAGAAGCGATTTATGCCACCCGATGCTCCGTCTGCCTGGTCTGGTGTGAGGAACGCCACGCGCTTTCCTCCTGTTTGCCCACAGAC	GGGACCTGTGGATCAATATC
gjd1a	GGCTTTCAAGAGGAGCCCCAAGAAGCTCATCACAGGTCAACAGAGGGACACTGGAAAAGTCGCCGAGGGCAGAGGTCGTGACACCTCAGGCTGAAGGTCGGCAGGGAAGTGAGAGTCATAAGCGCGGCATCATGGGAGAATGGACTATATTGGAGAGGTTGCTGGAGGCTGCGGTACAGCAGCACTCTACTATGATCGGCAGGTAAGAGCTCTAGTGCAACACACACACACTCCACAGAGTGCATG	GAGAATGGACTATATTGGAG
gjd1a_off01	CGCACACACACACACACACACACACACACACACACACACACACACACACACACACACACACACACACACACACACACACACACACACACACACACACACACACACACACAAACGAGATTGGAGGAGAGAGTGAGGAGAATGGATGTGATTGGAGGACAGAGAAAGGAGAATGGACGGTATTGGAGGAGTGTGAGAAGAGAATGGACGTGATTGGATGAGTGTGAGGGGAAAATGAATGTGATTGGAGGAGTGTGAGAGGAGAATGGACGTGATTGG	AGAATGGACGGTATTGGAGG
gjd2a_off01	TGTTTCTACCACTGATCGCATCACAGTACTAATCCACAGAGCTGACTGAAATATTAATGTTTTGCTTCCTGTACAAGTGCCTATACTTATATCTTTCAATTCTTTAGTACCGTAAGCATGAACACTGCGAAACCGCTGAATCCAACATGAGGAGGAGTGGAAGGGTAATGGAGGATACTAGAGAAGGCCTGGTGGTGGAAGATTGGTTTAATGCAGACTGCATTTTCACTGTAGGCATATCAGATACCGAGGAGAAAACATCAGCGC	GGTAATGGAGGATACTAGAG
cntn3b	TGACTGTGAAAAGCCCTTTGATGTTAACAGACAGACAGTGTGTGATTTTTGAAACACCTTTCTTACCATCGTTTCTTAGAACCAACGGTGTCGGCGAACTGAACACCCTCTCCTTGGTAATAGTGTTGTTAACCACACAGGTGTAATTCCCGACGTCGGACGGTTCCACTTTTGCTATGTAGAGATTCCCCGTTTCTTGAGATACAAATCGCCGGCTGTCTTGCTGGACGAAGTGAGGGTACTCA	GTGTAATTCCCGACGTCGGA
cntn6	TGGCCAGTTATTTCCCTCCCTTTGACTTTACATATAAAATAATTCAAATAAATAGGCAAAACATAACATTCTAGCAATGCTTTCTGAATGTCATTCTTTTTCTTTAAATAACTGAGTTTTAAAAGAAATTTTTAGCAAAACAGTTTTCAATGGTAACACATATTTGTTTTCCTTGCCAGAAATCAGATATTCCTGGATATTTAATGGCCGTCCGAGTGTCGCTGTTGGGGACAATCGGCGCTTTGTGTCCCAGCGGACTGGAAACCTCTACATCGCCAAGGTGGAGACGTCAGATGTGGGGAA	GGCCGTCCGAGTGTCGCTGT
cntn4	TTCGGGGCAGTAGATTGACCTCTTTCTTCTCATGTGTGACGTTGATGGTCTTCTCTCTCTTTTCTTCCTTTTACAGCTTTGACGTTTTCCTGGATTTTTAACGAGTACCCATCAATCGTGAAGCAGGACTCTCGTCGCTTTGTGTCTCAGGAGACAGGGAATCTGTATATCGCTAAAGTTGAGCCGTCGGATGTAGGAAACTACACCTGTGTCGTGACTAATACCGTCACCAAAACACAAGTACAAGGGCCGCCAA	GTACCCATCAATCGTGAAGC
nrxn2b_L	TCATCATCAGCGAGTGTGAGATGGAGTCCCGGCGTGTGTTTTGGGTGTGTGTGCTGCTGTTGTCTGGCGTGTGTGTGTGTGCATCTCTGGAGTTCGGCGGGGCTCCGGGGCAGTGGGCACGGTACTCTCGGTGGGAAGCGGGATCTGTGGGAGAGCTCAGCTTCAGCCTGAAGACCAACATCAGTAAAGCTCTGGTGCTGTATCTGGATGATGGAGGGAACTGTGATTTCCTGGAGCTGCTGATCTCTGGA	GTGGGCACGGTACTCTCGGT
nrxn2b_S	GCGTGGTGCTCAGACTGGAGGATACTCTAGCTGAAACTGCTGGACCTGGAAAAGCCAGCAGTGCCAACGACAAAACCAGCCGCCATAACCCAGACACGCTGGTCCAGAAGGCCCTGGGCGGAGCTACAGCCGGGGCTTGTGGGTAGAGCACTAATCCACCAGTCAGAAGCAGAGCCCTGAGGGCGGAGGAGAAAGGGGGCGGGGCTTCCATGCCACGCCTCCTCACGTGACAAAAACAGGAAGACATGTCAGACCAAGCCG	GGAGCTACAGCCGGGGCTTG
nlgn2a	CCCATTCCTGTCCTCCCTATTCTTGCTCCTCAAACAACCAAAATAGAACAGACAGGGTCACATTTCTTACTCTAGCAGTCCTTTTTACTTCACCCTTACCAATTAAATCAGAGGCCAATAAAACAGCGAAAAACAAAACAGGACAGTCATGTATTTGCCTCATGCCTGTAAACGGGATTTGGGCTATGCCCACAATTCAGAGGTCACTCACACAATAGCTCTCTTCTGGTTGGCACTGTGGATCACTTTGGCATCATGTCAACGCATCGATCCTGGCACT	GGGCTATGCCCACAATTCAG
tjp1a_L	CACCTCACGCCATTAACAAAGAGGAGAAATACCTGCTGACACAAACTCATTCTCTGTGCTATGAAGTTTGTCCTAACAGACTGCTTTTTCTCTGTTTCTCTCTCTCCTAGAGTACAACAATGGAGGAAACTGTCATATGGGAACAGCATACGGTGACTCTTCACAGGGTGAGTGTTGAACATAGCTTCTTTTTCCTGTTCTCAATTGTTGCTTCTTTAATCTTTTTTATTTCACACTTCATAATCTGATGAGGGC	GCATACGGTGACTCTTCACA
tjp1a_B	TGCACGAGTACAAATGTGCACACAGAGCTTCTGTCCATGAAAGGCTGACCCAGTTTTATTCTATTAGCAGGCCCAGTATGAAGCTGGTGAAGTTTAAGAAAGGGGAAAGTGTCGGATTGAGGCTGGCTGGAGGAAACGATGTGGGGATCTTTGTGGCTGGAGTTCTGGAGGACAGTCCTGCTGCTAAGGAAGGCCTGGAGGAGGGAGACCAGATACTCAGG	GGAAAGTGTCGGATTGAGGC
tjp1b_L_off01	AAAAAGAATGCCTTTTTATGTCACTGTACACATATACAATGTACATTATATACAGTGCGATGATTTAAAATGCATCTAACTACTCAGTGCTGAAGATGAAGATAACTGTAGATGATAAACAGTAGTGCAAAAATGGATGAGAGGGGCATAGGGTGAGGTAAACAGTGTTCTACAACTGAAGTTAGAATTATTAGACCCCTTTGATTTTTTTTTCTTTTTACAATATTTCCCAAATGATGTTTAACAGAGCA	TAGTGCAAAAATGGATGAGA
tjp2b	TGAACCGTACAAGAGCAGTCCATCGGCCGGTCCTCCTGGCAGCACGTCTGACACGATGATGGACGTCTCCCCGCTCTCCACGTTTGGATTGTCCCGGCCGCCGGACACAGCAATTCCAAAGCCCATCTTAGCGTCCTACGAGAGAAAGACACAGAGAAAAACACTTTGAGTGTGAAAGTATCCGCAAATGTATTTCTGCAGTCATGCATCACAGCCCGCGGCGGTGCAGTTTTAATATCGTTTCATGGGGACGTGCAAACAGCTAG	GTTTGGATTGTCCCGGCCGC
cntnap5a	GGGGGCTTTAAATGACAAACAGTGGCAGTTTGCTTATCCATATGTCTTTGTGTATTGAGCAAGGGCATTCTACATTACACTCAAAATCAAAAACCATTTTAATAAACGCTGACTGAGTTCTAATCGGCTTCTCTAGGAGGAGGTGGCTGGAGCCCCGAGTGGATGGACAGGTCTCCTTGGCTGCAGGTCGACCTCCAGGACAGAATGGAGGTGACAGCAGTGGCCACACAAGGACGTCACAGCAGCACAGACTGGGTCAGTGCTTACATGCTCC	GGACAGGTCTCCTTGGCTGC
nlgn4b	TCACCATGATCCAGCACATCCTCAGTGTGTTCTGTGGATTTACGCTGGCTCTGGCTCAGCAGACGCAGTTCATTACTGTGACCACTAATTACGGGAAGCTCCGCGGGCTCCGTGTGGCTCTTCCCAGTGAGATTTTGGGCCCCGTGGAGCAGTTTTTGGGCGTCCCGTATGCTATGGCCCCTACAGGAGAGCGTCGTTTTCAGGCCCCGGAGCCGCCGCTGTCCTGGCCGGGGATCAGGAACGCCACACAGTTCGCT	GAAGCTCCGCGGGCTCCGTG
