gjd1a	GGCTTTCAAGAGGAGCCCCAAGAAG
gjd1b	GCCATCGGCGGAACTATTTTTA
gjd2a	CCACAACTGCGGACACTGAGAGGAA
gjd2b	AGACGCGAAACAGTTGCTCGCATT
cnsta	CATGCACTGCTCTCAGAAAGCCTGA
cnstb	TGCGTAAGCGACAGAAGGGTGAAGA
nlgn1	GCCTGGATCTGCCATTCTTGTGTTG
nlgn2a	CCCATTCCTGTCCTCCCTATTCTTGC
nlgn2b	AGACGGTTCGCTCCTGTCCACGAC
nlgn3a	GGGCAAGGCTACTACCCCACAGTCA
nlgn3b	GTCTGTGGGCAAACAGGAGGAAAGC
nlgn4a	TGGGTTGTACCTTGGCTTTGGAGGA
nlgn4b	TCACCATGATCCAGCACATCCTCAG
nrxn1a_L	ACAATGAGCTTCTCAATGCGGAACG
nrxn1b_L	GCAACAATAACATCTGGTGCCACCTT
nrxn2a_L	TGCAGTGGATTAAGGGAAACGGAACA
nrxn2b_L	TCATCATCAGCGAGTGTGAGATGGA
nrxn3a_L	TGACCTTTGAACCAAAGCGAATTCAA
nrxn3b_L	TGTAGCATACGCTCTGGCTACCATGC
nrxn1a_S	CAGGTGGTTTGAGGACACCCCTCTT
nrxn1b_S	CCGGTGTGCTGAAGTGTGTGTTTGT
nrxn2a_S	TGATTGATATGGGCACCGCTCTTTG
nrxn2b_S	CGGCTTGGTCTGACATGTCTTCCTG
nrxn3a_S	AGTGTGAGTCGGGTGTGCGTTATGC
nrxn3b_S	AACGGACGTCAGGTTCTGCTCACCT
tjp1a_L	CACCTCACGCCATTAACAAAGAGGA
tjp1a_B	TGCACGAGTACAAATGTGCACACAG
tjp1b_L	CCTTCAGGCCGTGTGGGAATGTAAC
tjp1b_B	CATGGCCCGTTTCCACTGCAATAA
tjp2a	AAGATCGGAAAAACCCTCCACATCAA
tjp2b	CTAGCTGTTTGCACGTCCCCATGAA
tjp3	ATTCCAAGGTGGGCTTTGGTTTTGC
cntn1a	ACCAGCCAGTGCGGCTTATCTGAG
cntn1b	GGCGGGGCTTACCCATAGCTCAAT
cntn2	TTTTTGGTAGGTGGGGATGTGTGTG
cntn3a	TCCAAAGAGATGCGGTTCAGTATAGC
cntn3b	TGAGTACCCTCACTTCGTCCAGCAA
cntn4	TTCGGGGCAGTAGATTGACCTCTTTC
cntn5	TTGCTTTTGCAGTTGGCTGATCAAT
cntn6	TGGCCAGTTATTTCCCTCCCTTTGA
cntnap1	ATTTTCTGATGACGCAGGGAGCAGT
CNTNAP2	TGCGGTGTGCACTAAAGCATCGTAA
cntnap2a	CAGGGGGTGATCTCTTACCGCTTCA
cntnap2b	GGAACGCTGCTTCTTTCAACACACC
cntnap4	TCAATTGTGTGGATTCCGGCATTTC
CNTNAP5	AGCGAGTGCCTGAATTGTGAAGAGAA
cntnap5a	GGGGGCTTTAAATGACAAACAGTGG
cntnap5b	AGCAACGCTGGAATTGCTCACTCCT
gjd1a_off01	CCAATCACGTCCATTCTCCTCTCACA
gjd1a_off02	TGCATCAACAGAGTATTGAGCAAAGG
gjd1a_off03	ACGCTGAGGTCAGCAACAGACTTGC
gjd2a_off01	TGTTTCTACCACTGATCGCATCACA
tjp1b_B_off01	GCAAATGAAAAAGAAAGCCAAACCA
tjp1b_L_off01	AAAAAGAATGCCTTTTTATGTCACTG
tjp1b_L_off02	GACAGTGCGCTGGTTGAACCGTGT
