cnsta	CATGCACTGCTCTCAGAAAGCCTGAAGCACAATTACTGCTGAACTATGAGTCAGTTCAGTTAAAGGCCGGCTATTTCTTTACTGTTCCTGATTATTCTGTGTCTCCCAGAGGCAGAGCGGAGCGGCGTCCAGTGCCTGAGCGGATCTTGATGGATGACGGTCAGTGGCAGAGCGACGGCCCTGTAAGGAGAGGAGGAGCGACTGAGCCGGAGCTACAGAGCTGCTCTGAGTCCTTCCGCAGCCCTGATGACAACCACAACCGGCTGCT
cnstb	TGCGTAAGCGACAGAAGGGTGAAGAATTTAAAAAAACATTTTCAAGATAGATATGGTTTCATTTGGATTATGGTCTATCTTCTTTTTCATCACATCACAGTTATGGGGGAGTCCGAAAGCAGGAAATCGGTGAGATGGAAAGAGACGAGTGGAATCAACAAAGCATCAGAGGACATGATCATCTCTTACCTGACAGTCTCTGATGAGAATCAGAACAAACTGCCAGAAACAGAAGTCATGAACGCGG
cntn1a	ACCAGCCAGTGCGGCTTATCTGAGCTCTGTCTGCTTCAGGTGCGGTACTGGCGTGAGTCTGTAGAGAACGAAGCATCTGCTCAGCGGGTTCTGGTGTCCAGTCGAGAGAATCACACACGTCTGGACAACATGAAGCCCGACTCACACTACCTGGTGGAGGTGCGCGCGTGTAACGGAGCCGGATACGGACCCGCCAGCCAGCGCAACAGGATATACACCAAGAAGTCCCGTAAGTCCCTCAGCTGCA
cntn1b	GGCGGGGCTTACCCATAGCTCAATTGGAAGAAGTTCTGTAGCAGAAGTTCATTAATGAAATGCCGTATTTCACAGGTGGTGGTTAAACAACTGGCAAATTAAGCTGATGGAGCAGCCGGATGAGCACTTCAGCCTGGTTGGAGGAAACCTGGTCATTACAAACCCAGAAAAAAACAAGCATGCTGGGAAATATGTATGTGTGGCCAAGAACGTGTACGGCACCGTCATGAGCAAAGAGGCCAACGTCAAGTTTGG
cntn2	TTTTTGGTAGGTGGGGATGTGTGTGTGTCGGGTCATGACAGTGGGCCGGTGTTTGAAGAGCAGCCATCTAGTCTGATTTACCCAGAGGGGATGCCAGAAGGCAAGGTGACCCTGAGCTGCCAGGCTCGCTCCAGCCCTGCTGCTGTTTACCGGTACTCACATCACATTTTTGTCATTTACACGTGAACGAACAAAACACGACCTTTACTTGC
cntn3b	TGAGTACCCTCACTTCGTCCAGCAAGACAGCCGGCGATTTGTATCTCAAGAAACGGGGAATCTCTACATAGCAAAAGTGGAACCGTCCGACGTCGGGAATTACACCTGTGTGGTTAACAACACTATTACCAAGGAGAGGGTGTTCAGTTCGCCGACACCGTTGGTTCTAAGAAACGATGGTAAGAAAGGTGTTTCAAAAATCACACACTGTCTGTCTGTTAACATCAAAGGGCTTTTCACAGTCA
cntn4	TTCGGGGCAGTAGATTGACCTCTTTCTTCTCATGTGTGACGTTGATGGTCTTTTCTCTTTTTTCTTCCTTTTACAGCTTTGACGTTTTCCTGGATTTTTAACGAGTACCCATCAATCGTGAAGCAGGACTCTCGTCGCTTTGTGTCTCAGGAGACAGGGAATCTGTATATAGCTAAAGTTGAGCCGTCGGATGTGGGAAACTACACCTGTGTCGTGACTAATACCGTCACCAAAACACAAGTACAAGGGCCGCCAA
cntn5	TTGCTTTTGCAGTTGGCTGATCAATGGAACGAATGTGGACACAGAAGCAGATTTCCGCTACAGTTTGATTGATGGAAATTTAATAATACACAATGCAAGCGAAGTCATCGATTATGGAAGATACCAGTGCAGAGCTGAAAACAGCATTGGCATCGTCTTGAGTCGAGACGCCCTCCTGCAGTTTGCCTGTGAGTAATCTCGAACCC
cntn6	TGGCCAGTTATTTCCCTCCCTTTGACTTTACGTATAAAATAATTCAAATAAATAGGCAAAACATAACATTCTAGCAATGCTTTCTGAATGTCATTCTTTGTCTTTAAATAACTGAGTTTTAAAAGAAATTTTTAGCAAAACAGTTTTCAATGGTAACACATATTTGTTTTCCTTGCCAGAAATCAGATATTCCTGGATATTTAATGGCCGTCCGAGTGTCGCTGTTGGGGACAATCGGCGTTTTGTGTCCCAGCGGACTGGAAACCTCTACATCGCCAAGGTGGAGACGTCAGATGTGGGGAA
cntnap1	ATTTTCTGATGACGCAGGGAGCAGCGGCTGGTCTCCGTCTACTCGGGACAGGCAGCCATGGATGCAGATTGACTTGGGGAGGAAGTATCGTATTATGGCCATTGCTACTCAGGGTACCTTCAACTCTTATGACTGGGTCACCAAATACATGGTGCTGTACGGTGACCGCTTTGACTCATGGACTCCATACGTCATGAAAGGAGGCAACATGGTA
CNTNAP2	TGCGGTGTGCACTAAAGCATCGTAATTCAAACTTGGCATCTAGTGTTGTTTTCTTCCATTGTTCTTCCTCTTTGAAAGGCAATGGCGGATGGTCACCATCAGACTCGGACAGGTACCGGTGGCTACAGGTGGACCTCCGGGCCAGAAAACAGATCACAGCCATCGCAACGCAGGGCAGATACAGCAGCTCAGACTGGACCAAAAACTACAGGCTCCTGTACAGCGACACTGGAAGCAACTGGAAACCCTATCGGCAGGAC
cntnap2a	CAGGGGGTGATCTCTTACCGCTTCAAAATGAAGAAGATGAAGATTCTGAAGGACGTGATAGCCCTGAAGTTTAAAACATCTGAGAGTGAAGGGGTGATTCTGCACGGAGAGGGTCAACAGGGAGACTACATCACCTTGGAGTTGAGAAGAGGCCGACTTCTGCTGCAGATAAACCTCGGTAAAACTCAGACCTGACATCTACTGCACACTCTTAAAAATAAAGCTGCTTTATTGGCATCAATGGTTCCA
cntnap4	TCAATTGTGTGGATTCCGGCATTTCTTACAGTGCATGTGTGTGTGTTGTGCAGGTGCTGGGGGCTGGTCTCCGCTGGACTCCAATAAGTATCAGTGGCTGGAGATCAAGCTGGAGCAGCGCACTGAGATTACGGGGGTCTCCAGCCAGGGCCGATACGGCAGCTCAGACTGGGTCACTCGCTACCTCCTCATGTTCAGTGACACGGGACACAACTGGAGACCGTACCGCCAGGAAGACAGCATAGG
cntnap5a	GGGGGCTTTAAATGACAAACAGTGGCAGTTTCCTTATCCATATGTCTTTGTGTATTGAGCAAGGGCATTCTACATTACACTCAAAATCAAAAACCATTTTAATAAACGCTGACTGAGTTTTTATCGGCTTCTCTAGGAGGAGGTGGCTGGAGCCCCGAGTGGATGGACAGGTCTCCTTGGCTGCAGGTCGACCTCCAGGACAGAATGGAGGTGACAGCTGTGGCCACACAAGGACGTCACAGCAGCACAGACTGGGTCAGTGCTTACATGCTCC
cntnap5b	AGCAACGCTGGAATTGCTCACTCCTTTTGTTCTTGTGTTAGGAGGTGGCGGCTGGGCTCCGGAGCGAACAGACAGGCTACGATGGCTACAGGTGGACCTGCGAGAAAGGGTCGAGGTCACAGCTGTGGCGACCCAGGGTCGTTTCGGGAGTCCTGATTGGGTTACGAGTTACATGTTGCTGTACAGTGACACAGGGAGAGCTTGGAAGCAGTTCAGACAGGAGGACA
gjd1a	GGCTTTCAAGAGGAGCCCCAAGAAGCTCATCACAGGTCAACAGAGGGACACTGGAAAAGTCGCCGAGGGCAGAGGTCGTGACACCTCAGGCTGAAGGTCGGCAGGGAAGTGAGAGTCATAAGCGCGGCATCATGGGAGAATGGACTATATTGGAGAGGTTGCTGGAGGCTGCGGTACAGCAGCACTCTACTATGATCGGCAGGTAAGAGCTCTAGTGCAACACACACACACTCCACAGAGTGCATG
gjd1a_off02	TGCATCAACAGAGTATTGAGCAAAGGCTGTGAATACTTACTGTACATGCGATTTTTCAGGTTTTTTATTTTTAATAAATCTGCAACAATTTAAATAAATCTTTTTTCATATTGTCATTATGGGGTATTGTGTGTAGAATTTTGAGGAAATAAATTAATTAAATCCATTTTGGAATAAGGCTGTAACATAAAAAAATGTGGAAAAAGTAAAGCGCTATAAATACTTTCTGGATGCACTGTGTATTAAACTCACTGCTCTAATATAGTCCATGTTCATGGCCATCCACAATCCAGGCCTCCTCTTGTTCCATGGTCACTGTCCAATCTTTCATTGCTCCACAGATCGCTG
gjd1a_off03	ACGCTGAGGTCAGCAACAGACTTGCACATTCTCTACAGCTGATCTAATGTTTGAAATGCAGATTTCAAGACATTAAAGCCCACCGAGAGTGTTAGTAGAGTAAAACCTTTGTGATATAGTACATGAAACCCCTAGTTCAAATATAACAGGCGGAAGGAGGATGTGATATATTGGAGAAGCAAACAGTTTGCTCTCTTCACAGAAAGACACCACATCATATAATCTGATTATGATGAAGTGCTCCATATGGAGGCTGATCAGTGTCACGAACAGCTCCTCTCATGCACAA
gjd1b	GCCATCGGCGGAACTATTTTTAGGAACAAAGTATTGCAGTTCCTGTTGACTACCTCAAAGAGAAGCCACGGAGACTGTAAGATATCTTTGGAGGTTTACTTAAAGGATCGCTCGGTGTCTATTATAGTGTCTATTGATCCCTGGATGTCTTCAGCACCCAGCCATGGGAGAGTGGACCATTTTAGAGCGCCTCCTGGAGGCCGCTGTGCAGCAGCACTCTACTATGATCGGAA
gjd2a	CCACAACTGCGGACACTGAGAGGAATTACTCGCGCTTTCGTCTGGATCTGGGGCAGAGTCTGCGGATGAGCAGCGATGGGAGAATGGACCATACTAGAGAGGCTCTTGGAGGCTGCTGTCCAGCAGCACTCCACTATGATCGGAAGGTAAGAGCTAATGTCAGCCTGTCTGACGCCGAAATTCAAGCTTTGCGGCGTTTTCGGAGTAGAAGAT
gjd2a_off01	TGTTTCTACCACTGATCGCATCACAGTACTAATCCACAGAGCTGACTGAAATATTAATGTGTTTCTTCCTGTACAAGTGCCTATACATATATCTTTCAATTCTTTAGTACCGTAAGCATGAACACTGCGAAACCAATGAATCCAATATGAGGAGGAGTGGAAGGGTAATGGAGGATACTAGAGAAGGCCTGGTGGTGGAAGATTGGTTTAATGCAGACTGCATTTTCACTGTAGGCATATCAGATACCGAGGAGAAAACATCAGCGC
gjd2b	AGACGCGAAACAGTTGCTCGCATTTGATTTCACACGGTTCTCTGTGTTACATTCGCCTCCGAATGAACAGCCATGGGGGAATGGACAATTCTCGAGCGTCTCCTGGAGGCGGCTGTCCAACAGCACTCTACTATGATTGGGAGGTGAGGGGAAAAAGTGTTGTGGAAAATGTTTATTGATAAAGTAGTACATTAAACAAAACACTGAGGTCATTACGCATTGACCCTTCTGACTAAGGGCGATTGGCTTCTGG
nlgn1	GCCTGGATCTGCCATTCTTGTGTTGGATAGTAGGCTTGGCCCTGCATGCCCAGCTGGCCGCTTCGGAAAAACTGGATGAAACGGACCCCATTGTCACTACCACTTACGGAAAAGTGCGGGGATTCAAAAAAGAACTTAATAATGAGATCTTGGGGCCTGTTATTCAGTTCCTGGGGGTTCCCTACGCAGCACCTCCAACAGGCGAAAGGCGCTTCCAGCCACCTGAACCCCCTATTTCGTGGTCAGAAATCCGCAACGCAACTCAGT
nlgn2a	ATTTACTGGTCGTCGAAATCTCCGATCGCCAGGTATTTTTTGGTAGGACAGAAGTAAAGCGTTAACGACTGCTTGGATGTTTTTTGCTTACTTCCTGTGAGTGTGATGAGGAAGTGTAAACAGCTCGCATGGAGGGCGTGTCTCTCTTATATGTTCCTGAATCTGTGATCATGGGAATTTCTCTTTAAAACATGTGTCTTTAGTGCTAGATTATGGGGGACGCGGCGGTAGCGAAGCGGCGGGAGCAGCTGACGCGGTGGTCGGGCTCCAGTACGGACAA
nlgn3a	GGGCAAGGCTACTACCCCACAGTCAATACACAGTATGGGAAATTACGGGGGGCGCGGGTTCCGCTGCATAGTGAGATCCTGGGACCAGTGGACCAGTACCTGGGAGTCCCGTATGCCACCCCACCGGTGGGTGAAAAACGATTCCTACCCCCTGAGCCACCCTCGTCTTGGTCCGGGATCAAGAATGCCACTCATTTTGCACCAGTGTGCCCACAAAACATTCACA
nlgn3b	GTCTGTGGGCAAACAGGAGGAAAGCGCGTGGCGTTCCTCACACCAGACCAGGCAGACGGAGCATCGGGTGGCATAAATCGCTTCTCTCCCACAGGCGGAGCGGCGTAAGGCACACCCAGATATTGATCCACAGGTCCCAGACCCTCCGTGGCAACAGCGACCCGCATCCCCCTCAGTCTGCCAAGAGCTGTGTTTACTGTTGGCTGGTAGGTCAGCGTTGATGCCACAGAGACTGACCACATCAACCACACGAGCA
nlgn4a	TGGGTTGTACCTTGGCTTTGGAGGAGTGGAGGACTTTGAATTCAAGCAACTCTGCCAACCGCAGCTGGACCATGTCACGGCTCGGAGGAACCCCATGGATACCACTTACCATGGTTCATCCGCTGGCTACTCTACGCCTTTTTACCTGGATTGTGCTTGCGGCTGCGTGGCTGGCCATTACACGGGCTCAGCAGCACCCTATTGTTACGACAAACTATGGCAAGCTAAGAGGCTTGAAAACACCTCTGCCCAATGA
nlgn4b	TCACCATGATCCAGCACATCCTCAGTGTGTTCTGTGGATTTACGCTGGCTCTGGCTCAGCAGACGCAGTTCATTACTGTGACCACTAATTACGGGAAGCTCCGCGGGCTCCGTGTGGCTCTTCCCAGTGAGATTTTGGGCCCCGTGGAGCAGTTTTTGGGCGTCCCGTATGCTATGGCCCCTACAGGAGAGCGTCGTTTTCAGGCCCCGGAGCCGCCCCTGTCCTGGCCGGGGATCAGGAACGCCACACAGTTCGCT
nrxn1a_L	ACAATGAGCTTCTCAATGCGGAACGGTGCACATCTAATCTGGATAGGCCTACTGGTTTGTTGCCTTGTCGACATGGGGGCCAGCATGGAGTTCACTGGTGCAGAAGGCCAGTGGGCAAGGTTTCCCATGTGGAACGCCTGCTGCGAAAGCGAAATGAGTTTCAACATGAAGACCAAAAGCGCTCATGGACTTTTAGTGTACTTTGACGACGAGGGATTCTGTGACTTCTTGGAACTGCTCATCCACAATGG
nrxn1a_S	CAGGTGGTTTGAGGACACCCCTCTTTAAAGTCCTTGCACTCCGGTAGCATGCTGCGTCTGTGGCCCGGCGGGGCTCCTGGTGGTCTTGCTTCCATCCTGCTCCGCATCAGCCTGCGCCTAGCTCTCTGGCTGCCACCGCTGACTTTGGGGTCAGCTCTGGCAGAGGGGCCTGGGGAGCTGTACGTCCCTCAACATATGCCTCATCACCTCGTGCCTGCCGCCAGATCCCACGCCCCCCTGCGGGCAGGACATGGTGCGTAGCTTATTCGACAGCCA
nrxn1b_L	GCAACAATAACATCTGGTGCCACCTTAAGCCTACTTTGGCATGCATAATTTGGAGATTTCCTATAGATTATTATTATTATAAACATGCCAAACATCTTCATGATGATTCTTCACTTGGGTGCTCATCTGCTTTTTATCGGACTAATTGTATGTAAAGCGAACGCTGGATCTAGTCTCAGGTTTACAGGATCCAACGAACAATGGGTTGCGTTTCCGATGTGGAACGCTTACTGCGAGAGCGAAATGAGCTTCAGTGTGAAAACCACACATCTGAATGGCCT
nrxn2a_L	TGCAGTGGATTAAGGGAAACGGAACATTAGAAAGGAAGGATTAGGAGCTCGCTTAGAAGATGATGACGCGAAAGTGGAGGTGCGTGAAGTTGTCACCGGCCTTCGTTTGGCTGGGGCTCATGGTCCTTTCTGTCGCCGTGGCCCTAGAGTTTGATGGTTTACCAGGCCAATGGGTTCGCTATGGACCCTGGGAAGCAGGAGCTACCGGTGAACTGAGCTTCACCATGAAGACGAACATCAGCAAAGCTATTGTGCTGTACCTGGATGATGGTGGA
nrxn2a_S	TGATTGATATGGGCACCGCTCTTTGAGATGTACTCTTTCCAACGGATGGGACAAATGGGGTGTGGAAGGGCCTACGCCGGGCCTTCTTGCCCCAAGCTGGAGGTGGTGCTGCTGGGCTGGGAGTGTGGTGGAGGGGGCAGCTGGCTGGGCCTCGGCTCTTGGTGGAGACTGGCGCTATCTCTGGCCTTGTTGGCCTCTGTGCCGGACAGATCTGCCAGCGCCCGTGTGTCTTCCAGCCTGAGCACCACACACCATGTCCATCACTTCCA
nrxn2b_L	TCATCATCAGCGAGTGTGAGATGGAGTCCCGGCGCGTGTTTTGGGTGTGTGTGCTGCTGTTGTCTGGCGTGTGTGTGTGTGCATCTCTGGAGTTCGGCGGGGCTCCGGGGCAGTGGGCACGGTACTCTCGGTGGGAAGCGGGATCTGTGGGAGAGCTCAGCTTCAGCCTGAAGACCAACATCAGTAAAGCTCTGGTGTTGTATTTGGATGATGGAGGGAACTGTGATTTCCTGGAGCTGCTGATCTCTGGA
nrxn3a_L	TGACCTTTGAACCAAAGCGAATTCAATGATTTCCTTCTGTTCAGGATAATAACCCCAAATCTCCAGCACTTTTACAATGAATTTCTTCAGATTCCCAGTCCAGTTGCAGCTGCTGATCAGTACTGTGCTTGGGCCCTGCTTGGGCCTGGAGTTTACAGGGTTGCAAGGCCAGTGGGCACGCTATCTCCGCTGGGACGCCAGCACCAGAAGTGACCTCAGCTTCCAGTTCAAAACAGACGTGTCCACTGCCTTAATCCTGTACTTTGACGATGGCGGC
nrxn3a_S	AGTGTGAGTCGGGTGTGCGTTATGCGTCCCAGCAGAGTGGCGGCGCCGTTTCGGGGCGGTCGCCAGGGATTGAGCCCATGGATGTGGTCTCTGACTTTGGGATGTATTGTGGGTTCGGTGTGGAGTTCCTCACCTGGCTTGGATAATTCAGTGGTCGCCGCTGGACCTCCTGGGGTGGCAACTTCATACACCCATCCTGAACACCCGGTCCACAACCCTCGGCACCACGCTTCACCCATTTCCATAT
nrxn3b_S	AACGGACGTCAGGTTCTGCTCACCTGTTTCTCTCAATACACCTGCTAAAAGCTGTCTACTCTTGCAGCAAGGAGGGGACGATAGCTATGCGCCCCCACTTTAAGACCCGATACCCCCAGTGGCTTTCCTGCATGCTACCCCTGGTCACAGGGTGCGTGTTCGGAGCCGTATGGGGCTCGAACCTTGATAGCACAGTCGTCCTCTCGTCCTCCACATTCTCACATTCTGAAACACAGCACCACCATCACCTG
tjp1a_B	TGCACGAGTACAAATGTGCACACAGAGCTTCTGTCCATGAAAGGCTGACCCAGTTTTATTCTATTAGCAGGCCCAGTATGAAGCTGGTGAAGTTTAAGAAAGGGGAAAGTGTCGGATTGAGGCTGGCTGGAGGAAACGATGTGGGGATCTTTGTGGCTGGAGTTCTGGAGGACAGTCCTGCTGCTAAGGAAGGCCTGGAGGAGGGAGACCAGATACTCAGG
tjp1a_L	CACCTCACGCCATTAACAAAGAGGAGAAATACCTGCTGACACAAACTCATTCTCTGTGCTCTGAATTTTGTCCTAACAGACTGCTTTTTCTCTGTTTCTCTCTCTCCTAGAGTACAACAATGGAGGAAACTGTCATATGGGAACAGCATACGGTGACTCTTCACAGGGTGAGTGTTGAACATAGCTTCTTTTTCCTGTTCTCAATTGTTGCTTCTTTAATCTTTTTTATTTCACACTTCATAATCTGATGAGGGC
tjp1b_B	CATGGCCCGTTTCCACTGCAATAAATAAAGTGATGTATTAATAAAGTCTTGCATTGTTTTGATATAGGTATTCAGTCATTTCAGTAAACTGATTTTAGTGCATGTAATCATTTGAAGGTGTTGAGAGAGAGCAGTCTCAGATGTGTGTTTGTGTGTCCGTCCTCAGGCCGAGCATGAAGCTGGTGAAGTTTAAGAAGGGCGAGAGCGTGGGCTTGAGGCTCGCTGGGGGGAACGACGTTGGGATATTTGTGGCGGGAGTTCTGGAGGACAGTCCTGCTGCTAAAGAGGGCCTGGAAGAGGGAGACC
tjp1b_B_off01	GCAAATGAAAAAGAAAGCCAAACCAACAGTGAAAAGTCTAATTATTTCCATTAACCTGATGATTTTAATTGAGATCTCCAGTGATATGTCTCCAACGCAGACGGGAAGCGCTTGTGGCTCGCTGGAAGTTGATAAAGGAATCTCAGTCCGCGAGCTTTTAAAATTAGGATAGGAAATTGGAGCAAGCCAAAATGGAGACTTTAATTTTACAGAATTATTGTGACGCCCGGGGGCTTGAACCGAATGATTGCTGCCTGTTCT
tjp1b_L	CCTTCAGGCCGTGTGGGAATGTAACCAATTAAAGCTGTTGATGTTAATCTAACGATTTGTGTGTTTCTCTATTAATCTCTTTCCTTCTTTCTGTGTGTTTTTTCTTCAATGCAGAGTGCAGCAATGGATGAGACGGTAATATGGGAACAGCACACTGTAACTCTACACAGGGTGAGAATTTCACTTTTTTTTTTTTTTTTCGATCTCTGATATTTTTGTGTGTTTGGAGTCCCAGAGCAGA
tjp1b_L_off01	AAAAAGAATGCCTTTTTATGTCACTGTACACATATACAATGTACATTATATACAGTGCGATGATTTAAAGTGCATCTAACTACTCAGTGCTGAAGATGAAGATAACTGTAGATGATAAACAGTAGTGCAAAAATGGATGAGAGGGGCATAGGGTGAGGTAAACAGTGTTCTACAACTGAAGTCAGAATTATTAGACCCCTTTGATTTTTTTTTCTTTTTACAATATTTCCCAAATGATGTTTAACAGAGCA
tjp2a	AAGATCGGAAAAACCCTCCACATCAATTAATGTATGGATTCATTACATTTTTATGAAACCAATTCTATTCCTTGATGTAGGACTCCAAGATGGGCTTTGGCCTAGCGGTGTCTGGAGGACGGGACAATCCAAACGAAGAAAGTGGAGAAATGTCAATCGTCATATCTGATGTGCTGCAAGGGGGTCCAGCCGATGGCTTGCTGTTGTAAGCTATAATATTATATTTCTTTCAACACAGCCCTCAACCTGTGA
tjp3	ATTCCAAGGTGGGCTTTGGTTTTGCCGTCTCAGGTGGGCTGGACAAACCCAACCCAGCAAATGGGGACGCGGCAGTGGTGGTCTCTGATGTGATTCCCACCGGTCCCGCCATGGGCCGACTTCAGTGAGTGCACGTGTTTCCTCCTCCACATCCTGCATAAATCCTGTAGAACCTGTCGTGTTTGTGTACAAGACTGAAAAACTAAACTCACTTGCCAGCTGATTTTGGTGATAGAGACTCATGTGATTTCTTGCCCGTAGGACGC
cntn3a	TCCAAAGAGATGCGGTTCAGTATAGCTTATTACACTTCTTGTCTCCTACAGAGTTGACCTTTTCCTGGATCTTCAACGAATATCCCTCATTCGTCGAGCAGGACACGCGGCGCTTTGTGTCACAGAAAACAGGCAACCTGTACATTGCTAAAGTGGAGCCGTCGGATGTAGGGAACTACACCTGTGTCGTGACTAACACTGTGACCCAAAACAGAGTGCAAGGACCTCCTACGCCTCTTATTCTCCGCAGTGATGGTGATACTCC
tjp2b	TGAACCGTACAAGAGCAGTCCATCGGCCGGTCCTCCTGGCAGCACATCTGACACGATGATGGACGTCTCCCCGCTCTCCACGTTTGGATTGTCCCGGCCGCCGGACACAGCAATTCCAAAGCCCATCTTAGCGTCCTACGAGAGAAAGACACAGAGAAAAACACTTTGAGTGTGAAAGTATCCGCAAATGTATTTCTGCAGTCATGCATCACAGCCCGCGGCGGTGCAGTTTTAATATCGTTTCATGGGGACGTGCAAACAGCTAG
tjp1b_L_off02	GACAGTGCGCTGGTTGAACCGTGTCCAGAATCAGTCGGTTCTGTGCGTATGCGAGGCCACGACTGGAGCCTGTTCAGAGGTGAGAGGTTACCATCTCATCCACTGCTGCCCGCTGGGTATCTTTACTTGTAAAGTGTCCATCGATCTGCCTCTCATTTCTTATTCTGCTCAGAACATGCACAGAATCTCTTGCTTCTCTTCTGCCGGCTCAGCCTAATTTCCT
nrxn3b_L	TGTAGCATACGCTCTGGCTACCATGCCTCCCCATTGCCAGCCTCATTGTGTACTCTTGCTGCTCAGCACCTTCTTGAGTCTTGGTTTGGGCCTGGAGTTCACAGGTTCAGAGGGTCAGTGGGCACGCTATCTTCGCTGGGATGCCAGCACCAGAAGTGACCTCAGCTTTCAATTCAAAACGGCAATATCAGATGCTCTGGTTCTCTACTTTGACGATGGAGGATATTGTGACTTCCTGCTTCTGAGTATTGAGGATGCCAAGCTCAAGTTGCATTTTAGCGTGGACTGTGCAG
nrxn2b_S	CGGCTTGGTCTGACATGTCTTCCTGTTTTTGTCACGTGAGGAGGCGTGGCATGGAAGCCCCGCCCCCTTTCTCCTCCGCCCTCAGGGCTCTGCTTCTGACTGGTGGATTAGTGCTTTACCCACAAGCCCCGGCTGCAGCTCCGCCCAGGGCCTTCTGGACCAGCGTGTCTGGGTTATGGCGGCTGGTTTTGTCGTTGGCACTGCTGGCTTTTCCAGGTCCAGCAGTTTCAGCTAGAGTATCCTCCAGTCTGAGCACCACGC
nrxn1b_S	CCGGTGTGCTGAAGTGTGTGTTTGTGCTCCGGGAAGATGTTTGGAGGCTGGAGGCTGGTGGTTTGGCAGATTTTTTCGGAGATCATCACTCGGGGTTTGGGCTTCTGGATCTGCCTGTACTTCGCAGCTCTGTCTGTGGGCATGATTTCTGGATCGGAGCCCCTCGTCAGGACACGACACATCCAGAATACACACACTGTGCCTATCAACAGGTCACCGGGGTCTCTGCGGGCATGGCAGGGTGGGTACAACAGTA
nlgn2b	AGACGGTTCGCTCCTGTCCACGACGCATATCTGACACTTGCCTGGTGTGGCTGCTGGGCTTGGCGCTGCGCCTTGCGCTATCCTCCTGCCAACGGGCAGACCTCACCACCGCCAAGCACCCTATGGTCACCACAGGCTACGGGAAGCTTCGGGGAGTACGCAAGGAGCTGAACAATGAGATTCTAGGCCCGGTCGAGCAGTACTTGGGTGTCCCCTACGC
gjd1a_off01	CCAATCACGTCCATTCTCCTCTCACACTCCTCCAATCACATTCATTCTCCTCTCACACTTCTCCAATCACATTCATTTTCCTCTCACACTCCTCCAATACCGTCCATTCTCCTTTCTCTGTCCTCCAATCACATCCATTCTCCTCACTCTCTCGTCCAATCTCGTTTGTGTGTGTGTGTGTGTGTGTGTGCG
CNTNAP5	AGCGAGTGCCTGAATTGTGAAGAGAATTACCCCCTGAATTCTGTTTCATTCCTCTGCAGTTTTTAAAGCACTGCCTCTTATTCTGTCCCCCTAGGAGGTGGGGGGTGGTCTCCGAGCGGAGAAGACCAGCAACCTTGGCTTCAGCTGGACCTACGGGACAGGTTGAAGGTCACATCCATTGCCACCCAGGGTCGCTGGGGCAGCTCTGACTGGGTGGCCCGGTACCAGCTACACTACAGTGACTCTGGACGAACCTGGAGACCGT
cntnap2b	GGAACGCTGCTTCTTTCAACACACCTGCATCTTATCTTCATTTTCCAACCTTACAAGCTGAGACCAGTGCTGATATGTCCTTTTATTTCAAGACATCGGCTTCACACGGAGTCTTTCTGGAGAACCTGGGCAACCCCGACTTCATTCGCCTAGAACTCAGTTGTAAGCTTATTTTTATCACTTCCCCTCGAGAGGATTTACCTTTTAAGCACTGTGAGGAACTGCGCTTTAAAGTCCC
